1111111111111111111111111111111111111111
100C0000000000000100C10101C1101010000C11
10110101111001000001010C00001C0000111101
1001010100100001C1000000000001110001C001
1000000100010001111100000011000000010011
1011000000011111C00100000101000000011001
1000100011110001000100000001111000000001
1000010100000000011100010001P10011100001
1000111000010001000011000011010110000001
110C1111011001C0001001011111000000001111
11010C1111001000010000000001000011100101
1000C01100001000010000000110000010000111
10000100011100000010010001000010000100C1
10000110C11000000000000011011111111C1111
10100011110001110000110000100000001CC001
1001000010001000100010000010001000111101
100C100000010010010000010010111000000001
10010000110010010010001110001C0011111001
1111110001100001100110E010011111100100C1
100000C00011100111C11101100000C000000011
1111111111111111111111111111111111111111