1111111111111
1P010000C0001
1000011111001
10E0110000001
1111111111111